SHAPESTART
EMPTY|0|
WALL|1|
FLOOR|2|
DOOR|3|
SHAPEEND
MAPSTART
1|3|1|1|0|0|0|0|0|0|0|0|0|0|0|0|
1|2|2|1|0|0|0|0|0|0|0|0|0|0|0|0|
3|2|2|1|0|0|0|0|0|0|0|0|0|0|0|0|
1|2|2|1|0|0|0|0|0|0|0|0|0|0|0|0|
1|2|2|3|0|0|0|0|0|0|0|0|0|0|0|0|
1|2|2|1|0|0|0|0|0|0|0|0|0|0|0|0|
3|2|2|1|0|0|0|0|0|0|0|0|0|0|0|0|
1|3|1|1|0|0|0|0|0|0|0|0|0|0|0|0|
0|0|0|0|0|0|0|0|0|0|0|0|0|0|0|0|
0|0|0|0|0|0|0|0|0|0|0|0|0|0|0|0|
0|0|0|0|0|0|0|0|0|0|0|0|0|0|0|0|
0|0|0|0|0|0|0|0|0|0|0|0|0|0|0|0|
0|0|0|0|0|0|0|0|0|0|0|0|0|0|0|0|
0|0|0|0|0|0|0|0|0|0|0|0|0|0|0|0|
0|0|0|0|0|0|0|0|0|0|0|0|0|0|0|0|
0|0|0|0|0|0|0|0|0|0|0|0|0|0|0|0|
MAPEND